XXXXXXXXXXXXXXXIXXX
X                 X
X XXXXXXXXXXXXXXXXX
X             X   X
X XXX XXXXX X X X X
X   X X   X X X X X
X X X XXX X X X X X
X X X     X X   X X
XXXXXXXXXXXOXXXXXXX

